1111111111111111111111111111111111
1E0000000000000C00000C000000000001
11101101001F00001F1001000010010101
1010010010101010001FFF000000010101
1P0000000C00C00000000000C0000000C1
1111111111111111111111111111111111