1111111111111111111111111111111111111111111111
10C00000000000000000000000000000000000000000E1
1000000000000000000000000000000000000000000001
1000000000000000000000000000000000000000000001
1000000000000000000000000000000000000000000001
1000000000000000000000000000000000000000000001
1000000000000000000000000000000000000000000001
1000000000000000000010000000100000011111111111
1000000000000000000010000000100000010000000001
1000000000000000000011111111100000010000000001
1000000000000000000000000000100000000000000001
1P00000000000000000000000000100000000000000001
1111111111111111111111111111111111111111111111