11111111111
10000F000E1
100FF00C000
1P001000001
11111111111